NO ./textures/eagle.xpm
SO ./textures/greystone.xpm
WE ./textures/purplestone.xpm
EA ./textures/red.xpm

F  000, 000, 000
C  100, 100, 100



11111111 111111111
100000011100000001
100000000000000011
1000000000W000001
111111011111110111
100001010101010101
101100010111010101
101111110000010101
101000011111010101
101101010000000001
100001000111010101
111111111111111111
