NO ./textures/eagle.xpm
SO ./textures/greystone.xpm
WE ./textures/purplestone.xpm
EA ./textures/red.xpm

F  000, 000, 000
C  100, 100, 100



11111111 111111111
100000011100000001
100000000000000011
1000000000W000001
111111111111111111
100000000000000001
111111111111111111
