NO ./textures/eagle.xpm
SO ./textures/greystone.xpm
WE ./textures/purplestone.xpm
EA ./textures/red.xpm

F  255, 0, 0
C  100, 100, 100


11111111 111111111
100000011100000001
100000000000000011
100000000N00N00001
111111111111111111
100000000000000001
111111111111111111
